acquila	akira
GetIn	Get In
MONSTAX	MONSTA X
skinh	ski nh
AI io	AIio
AZSEN	AZ SEN
NUEST	NU EST
College Gameday	College Game day
itv2	itv 2
hand bra	handbra
MONSTAX	MONSTA X
hand bra	handbra
democratic i	democratici
ORPOL	OR POL
womens day	women s day
The Take Over	The TakeOver
teeshirt	tee shirt
Bo TW	BoTW
HB93	HB 93
PLCs	PLC s
PROAct	PRO Act
VMwareNSX	VMware NSX
shed her	shedher
NCT127	NCT 127
marvels runaways	marvel s runaways
weare one EXO	we are one EXO
Cat fish domme	Catfish domme
MID TERMS 2018	MIDTERMS 2018
GDGMENA	GDG MENA
FAlkirk	FAl kirk
bell Lets Talk	bellLets Talk
S8 Ep 5	S 8 Ep 5
Master Chef Au	MasterChef Au
REinvesting	RE investing
PPOSITIVE	P POSITIVE
Ab Ag	AbAg
Bell Let	BellLet
hentai i	hentaii
Teeshirt	Tee shirt
the xfactor	the x factor
nikelondon	nike london
Hes Done	He s Done
Canpoli	Can poli
LOOK2	LOOK 2
age du	agedu
Dadis	Dad is
CM20	CM 20
Retro gaming	Retrogaming
The Big A	TheBig A
GIJOE	GI JOE
corevalues	core values
Cameltoe	Camel toe
B Line	BLine
trans women	transwomen
Xfiles	X files
chit chat	chitchat
p live	plive
Spy gate	Spygate
butt hole	butthole
prolifers	pro lifers
Dialup	Dial up
sun spot	sunspot
thering	the ring
san diego	sandiego
wego	we go
Boo hoo	Boohoo
Ripoff	Rip off
no cap	nocap
Daddys	Daddy s
high road	highroad
whats with	what s with
SA11	SA 11
bad min	badmin
Room48	Room 48
6Line	6 Line
xpass	x pass
ushist	us hist
LivePD	Live PD
The XFactor	The X Factor
Seri Video Kral 1	Seri Video Kral1
5 TP	5TP
cash cow	cashcow
over out	overout
SPOs	SPO s
RINGRING	RING RING
digital art work	digital artwork
Retro gamer	Retrogamer
Hand Written	HandWritten
TENLEE_1001	TENLEE _ 1001
MONSTA_X	MONSTA _ X
IAMME	I AM ME
off_tumcial	off _ tumcial
to do deku	tododeku
Peek A Boo	PeekABoo
dunla pphoto	dunlap photo
stree tart	street art
jeff stinco	jeffs tinco
jamp act	jam pact
BB log RT	B Blog RT
mom mab	momma b
onther eal	on the real
